2222222222222222222222222222222222222222
2000000000000000000000000000000000000002
2022222222222333333333222222222222222222
2000000000000000000000000000000000000002
2222222222222222222222222222222222222202
2000000000000000000000000000000000000002
2222222222222222222222222222222222222202
2000000000000000000000000000000000000002
2022222222222222222222222222222222222222
2000000000000000333330000000000000000002
2000000000000000322230000000000000000002
2000000000000000322230000000000000000002
2000000000000000000000000000000000000002
2000000000000000000000000000000000000002
2000000000000000000000000000000000000002
2022222222222222222222222222222222222222
2000000000000000000000000000000000000002
2222222222222222222222222222222222222202
2330000000000022222222200000000000000002
2330000000000000000000000000000000000002
2222222222222222222222222222222222222222