1111111111111111
1001110301010001
1001100011011101
1000000201000001
1001100200011011
1001100011111011
1000000300000011
1101110110111101
1100000000100001
1010110010100011
1000010010100111
1010010010100001
1010110010100111
1010000010000011
1011110000111011
1000001110011011
1000000000011011
1000000000011011
1110011001111011
1000000000011011
1000000000011011
1000000000011011
1002200220011011
1000000000011011
1002200220011011
1000000000011011
1111111111111111
